[12288,2048 , 12288,1356 , 9960,1356 , 9960,1326 , 9900,1326 , 9900,1296 , 9840,1296 , 9840,1266 , 9780,1266 , 
	9780,1236 , 9720,1236 , 9720,1206 , 9660,1206 , 9660,1176 , 9450,1176 , 9450,1146 , 9390,1146 , 9390,1116 , 9330,1116 , 9330,1086 , 9270,1086 , 
	9270,1056 , 9060,1056 , 9060,1026 , 9000,1026 , 9000,996 , 8940,996 , 8940,966 , 8880,966 , 8880,936 , 8120,936 , 8120,636 , 8020,636 , 8020,786 , 
	7990,786 , 7990,806 , 8020,816 , 8020,1056 , 7990,1056 , 7990,1076 , 8020,1086 , 8020,1196 , 6920,1196 , 6920,1026 , 6630,1026 , 6630,556 , 5850,556 , 
	5850,456 , 5570,456 , 5570,536 , 5540,536 , 5540,556 , 5570,566 , 5570,816 , 6380,816 , 6380,1026 , 6350,1026 , 6350,1046 , 6380,1056 , 6380,1156 , 
	5900,1156 , 5900,1256 , 5600,1256 , 5600,1356 , 5500,1356 , 5300,1386 , 4260,1386 , 4260,1056 , 4060,1056 , 4060,1386 , 3660,1386 , 3560,1336 , 
	3400,1336 , 3300,1386 , 2910,1386 , 2910,1186 , 1460,1186 , 1460.001,1336 , 1300,1336 , 1300,1256 , 980,1256 , 710,1346 , 
	230,1346 , 230.001,56 , 0,0 , 0,2048],

[3770,966 , 3770,1066 , 3860,1066 , 3860,916 , 4450,916 , 4450,1316 , 
	4770,1316 , 4770,1266 , 5270,1266 , 5270,1066 , 5770,1066 , 5770,986 , 6200,986 , 6200,946 , 4769.999,946 , 4770,836 , 
	5420,836 , 5420,766 , 5270,766 , 5270,46 , 3270,806 , 3270,966],

[7100,46 , 7100,946 , 7450,946 , 7450,1026 , 7860,1026 , 7860,966 , 7890,956 , 7890,936 , 7860,936 , 7860,666 , 
	7890,656 , 7890,636 , 7860,636 , 7860,456 , 8260,456 , 8260,816 , 8540,816 , 8540,866 , 8770,866 , 8770,826 , 9130,826 , 9130,276],

[3700,1246 , 3790,1246 , 3930,1246 , 3930,1276 , 3700,1276],

[3260,1276 , 3080,1276 , 3080,1246 , 3160,1246 , 3260,1246],

[2020.001,1116 , 2020,1056 , 2470,1056 , 2470,1116 , 2670,1116 , 2670,916 , 1620.001,756 , 1620,1116]